 ######################
                      #
#### ########## ##### #
#  #        # #     # #
# ########### ## #### #
#              #    # #
############## ###### #
# ####   #   #        #
#      #   #   #### # #
### ###################
#                      
###################### 