#############################################################
#                                                           #
#                                                           #
#                                                           #
#                                                           #
#                                                           #
#                                                           #
#                 # #########################################
#                 #
#                 # #########################################
#                 # #                                       #
#                 # #                                       #
################### #########################################