#############################################################
#                                                           #
#                                                           #
#                 #####################                     #
#                 #                   #         ###         #
#                 # ################# #         # #         #
#                 # #               # #         # #         #
################### #               #########################
                    #                                         
#############################################################
#                                                           #
#                                                           #
#############################################################