  #########
# # #     #
# #  # ####
# ##      #
#    #### #
### #     #
#########  