 ##################################
    #       # # ###               #
###  ###### # #  ## ############# #
# ## ###### # ## ## ###         # #
#              #  #   # ## ### ## #
############## ## ### #### ###### #
#            # #    #           # #
# ######## ### #### ############# #
#  ### ### # # #                  #
# ## #       # # ## ######## ######
# ## ######### # ## # ###### #### #
#                ## #             #
#################################  