 ######################
                      #
#### ########## ##### #
#  #        # #     # #
# ########### ## #### #
#              #    # #
############## ###### #
# ####   #   #        #
#      #   #   #### #  
###################### 